*PLAYERS*
1,0,0,0,1

*PUMP*
1,50,1,0,0
2,0,0,0,0

*PIPE*
1,50,0,0,0,0,0

*SET PUMP*
1,0,1,1
2,1,0,1

*SET PIPE*
1,1,2,0,0