*PLAYERS*
1,0,0,0,1

*PUMP*
1,50,1,0,0

*PIPE*
1,50,1,0,0,0,0

*SET PUMP*
1,0,1,1

*SET PIPE*
1,1,0,0,0